AHSV_TaqMan_VP7_Aguero	ATGAATGGTGTTGTYGCGCC	CTAATGAAAGCGGTGACCGT
AHSV_TaqMan_VP7_Fernandez	GGCTCCAACACTCACAAGATGT	GGCGGATTAATAGGCTGCATA
AHSV_TaqMan_NS2	AAGTGCTACRCATTACCA	TGGGAGAATCATGTAACTCA
#AIV_TaqMan_panA_comb1	agatgagycttctaaccga	gcaAaGacatcttcAagtytc
#AIV_TaqMan_panA_comb2	agatgagycttctaaccga	GCAAAGACACYTTCCAGTCTC
#AIV_TaqMan_H5_VLAmod	ACGTATGACTACCCGCRGTAT	AGRCCAGCYACCATGATTGC
#AIV_TaqMan_H5_RITA_FLI	GTTCCCTAGYACTGGCAATCAT	AATTCTARATGCAAATTCTGCAYTG
#AIV_TaqMan_H7RITA_FLI	AAATTGAGCAGYGGMTACAARGA	AAAACCARTCCCATTRCAATGGC
#AIV_TaqMan_H7_VanBorm_IZSVe	GYAGYGGYTACAAAGATGTG	GAAGACAAGGCCCATTGCAA
#AIV_TaqMan_H3_RITA_FLI	TGGATTTCCTTTGCCATATCATG	ATRCACTCAAATGCAAATGTTGCA
#AIV_TaqMan_H11_RITA_FLI	ARGTYAGGAATGGAACATATGAYCA	CAAATGGTACATCTACATGAYCCA
#AIV_TaqMan_N1	AGRCCTTGYTTCTGGGTTGA	ACCGTCTGGCCAAGACCA
#AIV_TaqMan_N5_RITA_FLI_comb1	AAGAGAGRACWAGCATTTGGAC	GGAAGAATTGCKCCATCAYC
#AIV_TaqMan_N5_RITA_FLI_comb2	AAGAGAGRACWAGCATTTGGAC	CAAAKGGAAGAATTGCKCCATCA
#AIV_TaqMan_N5_RITA_FLI_comb3	CTCCACKGTRTTTTGTGGTGT	GGAAGAATTGCKCCATCAYC
#AIV_TaqMan_N5_RITA_FLI_comb4	CTCCACKGTRTTTTGTGGTGT	CAAAKGGAAGAATTGCKCCATCA
#AIV_TaqMan_N6_RITA_FLI	AGGGTGAARATGAATCCAAAYCA	TGAARATGAATCCAAATCAGAAGATAA
#AIV_TaqMan_N8	GYTCCATTGTRATGTGTGGA	ACRTCTTRTCGATGTCAAARG
#AIV_TaqMan_N9_RITA_FLI	AGYATAGTATCRATGTGTTCCAG	AAGTACTCTATTTTAGCCCCATC
APPV_TaqMan_atypporcPesti	AGTTCAGAAATCCGGTAGCTG	CTACCAGCCTGAGGTCTTC
APPV_TaqMan_atypporcPesti_5utr_IVIBE_comb1	GGCAGACGTCACCGAGTAGTACA	TCCGCCGGCACTCTATCA
APPV_TaqMan_atypporcPesti_5utr_IVIBE_comb2	GGGCAGACGTCACTGAGTAGTACA	TCCGCCGGCACTCTATCA
ASPV_TaqMan_p72_IVI	gatgatgattaccttygctttgaa	tctcttgctctrgatacrttaatatga
ASPV_TaqMan_p72_King	ctgctcatggtatcaatcttatcga	gataccacaagatcrgccgt
ASPV_TaqMan_p72_Fernandez	CCCAGGRGATAAAATGACTG	CACTRGTTCCCTCCACCGATA
BTV_TaqMan_panBTV_IVI_Orru	tggayaaagcRatgtcaaa	acrtcatcacgaaacgcttc
BTV_TaqMan_NS1_Toussaint	GGCAACYACCAAACATGGA	AAAGTYCTCGTGGCATTWGC
BTV25_TaqMan_VP2_mod_FLI	GGTTCRATTTGTTATCGCTACTATA	ACAAGRCACTTCTCTGGATGTG
BTVGrueb_TaqMan_VP2_FLI	AACGATGATTATGCAAGGCAAG	CGCGACTGGTAAAGTATATACAAT
EHDV_TaqMan_NS1_P1	ACWGGVATCATGTTTGAGCT	TTCATAACYGCRCCTTCATC
EEV_TaqMan	GATAGCGGCTAGAGCCCTTTC	AACTTGAGGAGCCATRGTAGCT
JEV_TaqMan3NTR_FLI	GTGTAAGGACTAGAGGTTAGAGG	ATTCCCAGGTGTCAATATGCTGTT
#PestiV_TaqMan_panPesti	CCTGAGTACAGGRTAGTCGTCA	GGCCTCTGCAGCACCCTATCA | should be for BVDV, BDV, KSPV (whole genus)
#KSPV_TaqMan_5NTR_FLI	ATGCCCAYAGTAGGACTAGCA	CTAYTGACGACTRTCCTGTAC
MKSV_TaqMan_3D	ACTGGGTTTTAYAAACCTGTGATG	CCTGCCACRGARATCAACTT
MKSV_TaqMan_5NTR	CACTGGTGACAGGCTAAGG	CCCTTCTCAGATCCCGAGT
MKSV_TaqMan_5NTR_PB_IVI	CACYTYAAGRTGACAYTGRTACTGGTAC	CCCTTCTCAGATCCCGAGT
NDV_TaqMan_M_Wise	agtgatgtgctcggaccttc	cctgaggagaggcatttgcta
NDV_TaqMan_L_Sutton	GAGCTAATGAACATTCTTTC	AATAGGCGGACCACATCTG
LSDV_TaqMan_p32_pan_Capripox	AAAACGGTATATGGAATAGAGTTGGAA	AAATGAAACCAATGGATGGGATA
SPPV_TaqMan_(Sheppox)	AGGTACAAAATAATACCAACGATTC	GTTGATTTTTCAACATTTATGTATTGG
GTPV_TaqMan_(Goatpox)	CATTTGTTGATATAAACGTTCTTTACC	CTARAGATTTAGAAACRACGGTAAAA
PPRV_TaqMan	AGAGTTCAATATGTTRTTAGCCTCCAT	TTCCCCARTCACTCTYCTTTGT
PRRSV_EU_TaqMan_ORF(7+6)_comb1	GCACCACCTCACCCRRAC	CAGTTCCTGCRCCYTGAT
PRRSV_EU_TaqMan_ORF(7+6)_comb2	GCACCACCTCACCCRRAC	TGGAGDCCTGCAGCACTTTC
PRRSV_EU_TaqMan_ORF(7+6)_comb3	CAGATGCAGAYTGTGTTGCCT	CAGTTCCTGCRCCYTGAT
PRRSV_EU_TaqMan_ORF(7+6)_comb4	CAGATGCAGAYTGTGTTGCCT	TGGAGDCCTGCAGCACTTTC
PRRSV_US_TaqMan_ORF7	ATRATGRGCTGGCATTC	ACACGGTCGCCCTAATTG
SBV_TaqMan_S	TCAGATTGTCATGCCCCTTGC	TTCGGCCCCAGGTGCAAATC
SBV_TaqMan_L	TTGCCGTTTGATTTTGAAGTTGTG	TCAGGGATCGCAAATTAAAGAACC
SBV_TaqMan_M1	TCAATTCAGCAAGTAACATACAATGG	CGTGGTCTGTCTTGGTTGATG
SimbuV_TaqMan	GATGTWCCWCAACGGAAT	TGGGGAAAATGGTTATTAAC
SVDV_TaqMan_5NTR_Reid_2B	CGAGAAACCTAGTACCACCATGAA	CGGTGACTCATCGACCTGATC
SVDV_TaqMan_5NTR_Reid_3	CCCTGAATGCGGCTAATCC	CCATTACGACAGACTGCCCA
SVV_TaqMan_3D_FLI	AGAATTTGGAAGCCATGCTCT	GAGCCAACATAGARACAGATTGC
VSV_TaqManIndiana_N_gene	GATAGTACCGGAGGATTGACGACTA	AACCATCCGAGCCATTCG
WNV_TaqMan_5NTR_comb1	AGTAGTTCGCCTGTGTGAGC	GCCCTCCTGGTTTCYTAGA
WNV_TaqMan_5NTR_comb2	AGAAGTTCGTCTGCGTGAGC	GCCCTCCTGGTTTCYTAGA
WNV_TaqMan_NS2A	GGGCCTTCTGGTMGTGTTC	RATCTTGGCYGTCCACCTC
