AHSV_TaqMan_VP7_Aguero	GCTAGCAGCCTACCACTA
AHSV_TaqMan_VP7_Fernandez	TGGCACGCCTTACGCGC
AHSV_TaqMan_NS2	TGCTgTGcTaATgAc
AIV_TaqMan_panA_comb1	TCAGGCCCCCTCAAAGCCGA
AIV_TaqMan_panA_comb2	TCAGGCCCCCTCAAAGCCGA
AIV_TaqMan_H5_VLAmod	TCHACAGTRGCGAGYTCCCTAGCA
AIV_TaqMan_H5_RITA_FLI	CTGGTCTATCYTTHTGGATGTGYTCCAATG
AIV_TaqMan_H7RITA_FLI	TGGTTTAGCTTCGGGGCRTCATGYTT
AIV_TaqMan_H7_VanBorm_IZSVe	TGGTTTAGCTTCGGGGCATCATG
AIV_TaqMan_H3_RITA_FLI	CTAATGTTGCCTYTYTGGCAGGCCCACAT
AIV_TaqMan_H11_RITA_FLI	ATTTACAGCTGCATYGCAAGYAGTCT
AIV_TaqMan_N1	ATYTGGACYAGTGGGAGCAGCAT
AIV_TaqMan_N5_RITA_FLI_comb1	TCMAGTGAGGTCCCAGGRTGGTC
AIV_TaqMan_N5_RITA_FLI_comb2	TCMAGTGAGGTCCCAGGRTGGTC
AIV_TaqMan_N5_RITA_FLI_comb3	TCMAGTGAGGTCCCAGGRTGGTC
AIV_TaqMan_N5_RITA_FLI_comb4	TCMAGTGAGGTCCCAGGRTGGTC
AIV_TaqMan_N6_RITA_FLI	TGCATHTCAGCHACAGGAATGACACTATC
AIV_TaqMan_N8	TGGWCRTGGCACGATGGAGCTATYC
AIV_TaqMan_N9_RITA_FLI	TTCCTBGGACAATGGAACTGGCC
APPV_TaqMan_atypporcPesti	GTTTCGACACCAAAGCTTGGGACACTCA
APPV_TaqMan_atypporcPesti_5utr_IVIBE_comb1	TGTAGGGTCTACTGAGGCT
APPV_TaqMan_atypporcPesti_5utr_IVIBE_comb2	TGTAGGGTCTACTGAGGCT
ASPV_TaqMan_p72_IVI	CCACGGGAGGAATACCAACCCAGTG
ASPV_TaqMan_p72_King	CCACGGGAGGAATACCAACCCAGTG
ASPV_TaqMan_p72_Fernandez	GGCCAGGA
BTV_TaqMan_panBTV_IVI_Orru	ARGCTGCATTCGCATCGTACGC
BTV_TaqMan_NS1_Toussaint	CYCCAcTGaTRTTgTAtTtTcTCAA
BTV25_TaqMan_VP2_mod_FLI	CCGGTTATCACTACAAAGTTGGACAC
BTVGrueb_TaqMan_VP2_FLI	ATTGGATACGCTTAAGACACACCTGG
EHDV_TaqMan_NS1_P1	TcATcACAcATCgGC
EHDV_TaqMan_NS1_P2	TCTCgGCATATgCGAgC
EEV_TaqMan	TATTTTTGC
JEV_TaqMan3NTR_FLI	CCCGTGGAAACAACATCATGCGGC
PestiV_TaqMan_panPesti	TGCYAYGTGGACGAGGGCATGC
KSPV_TaqMan_5NTR_FLI	TGGCGAGCYCCCTGGGTGKTCTAAGT
MKSV_TaqMan_3D	ATCCTCTCCTTYGCACGCCGTG
MKSV_TaqMan_5NTR	TGTTACCTCRGGGTACCTRAAGGGCA
MKSV_TaqMan_5NTR_PB_IVI	TGTTACCTCRGGGTACCTRAAGGGCA
NDV_TaqMan_M_Wise	TTCTCTAGCAGTGGGACAGCCTGC
NDV_TaqMan_L_Sutton	AATAGTGTATGACAACAC
LSDV_TaqMan_p32_pan_Capripox	TGGCTCATAGATTTCCT
SPPV_TaqMan_Sheppox	TGGTAAAATCAACAAATAATTTTATTG 
GTPV_TaqMan_Goatpox	ATGTAACAGATTTGTTTTTAATT
PPRV_TaqMan	CACCGGAYACKGCAGCTGACTCAGAA
PRRS_EU_Kl_mod_P	CCTCTGYYTGCAATCGATCCAGAC
PRRS_ORF6_EU2_P	ATACATTCTGGCCCCTGCCCAYCACGT
PRRSV_US_TaqMan_ORF7	TGTGGTGAATGGCACTGATTGACA
#PRRSV_US_TaqMan_ORF7	CDSDDFFSSDFSD
SBV_TaqMan_S	TTAAGGGATGCACCTGGGCCGATGGT
SBV_TaqMan_L	TCATCCGTGCTGACCCTCTGCGAG
SBV_TaqMan_M1	AAGCACTGGCCCGAAGTTTCACCT
SimbuV_TaqMan	GAGTCTTCTTCCTCAA
SVDV_TaqMan_5NTR_Reid_2B	TCGCTCCGCACAACCCCAGTG
SVDV_TaqMan_5NTR_Reid_3		ACTGCGGAGCAGATACCCACGCA
SVV_TaqMan_3D_FLI	TTCAAACCAGGAACACTACTCGAGA
VSV_TaqManIndiana_N_gene	TGCACCGCCACAAGGCAGAGA
WNV_TaqMan_5NTR_comb1	AATCCTCACAAACACTACTAAGTTTGTCA
WNV_TaqMan_5NTR_comb2	AATCCTCACAAACACTACTAAGTTTGTCA
WNV_TaqMan_NS2A	CCACCCAGGAGGTCCTTCGCAA
EGFP	ACAACAGCCACAACGTCTATATCATGGCC
HEV_rat	ACCGCCTTTGCTAATGCT
